1111111111111111111111111
1P00000000000000000000001
10000000000C0000000000001
1010000010011111111000001
1010000010000000001000001
1010000010000000001000001
101111111001111111100C001
1000000010011000000000001
1000000010011000000000001
1000000010011111111000001
1000000000000000000000001
1000000000000000000000001
11000C000000000000C000001
10000000000000000000000E1
1111111111111111111111111
