111111111111111111111111111111111
1E000000C0000000000000000000000C1
101001010010000010100101001001011
10100100101010100C100100101001011
1P0000000C000000000000C00000000C1
111111111111111111111111111111111
