1111111111111111111111111
1P00000000000000000000001
100000000000C000000000001
1000100000100111111110001
1000100000100000000010001
1000100000100000000010001
10C0111111100111111110C01
1000000000100110000000001
1000000000100110000000001
1000000000100111111110001
1000000000000000000000001
1000000000000000000000001
10000C000000000000C000001
10000000000000000000000E1
1111111111111111111111111
