1111111111111111111111111
1P00000000000000000000001
1000000000000000000000001
10C00000C00CCCCCCCCC00001
10C00000C000000000C000001
10C00000C00000000C0000001
10C0C0C0C0000000C00000001
10000000C000000C000000001
10000000C00000C0000000001
10000000C00CCCCCCCCC00001
1000000000000000000000001
1000000000000000000000001
1000000000000000000000001
10000000000000000000000E1
1111111111111111111111111
